111111111100
1itemA   1 0
1111111111 0
111111111111
1itemB     1
1          1
1          1
1          1
1          1
1          1
1          1
1          1
111111111111
11111111   0
1itemC 1   0
1      1   0
1      1   0
11111111   0
111111111  0
1itemD  1  0
1       1  0
1       1  0
1       1  0
1       1  0
1       1  0
1       1  0
1       1  0
111111111  0
1111111    0
1itemE1    0
1     1    0
1     1    0
1     1    0
1     1    0
1     1    0
111111100000
