0000000000000000000000000000000000000000
0root                                  0
0                                      0
0                                      0
0                                      0
3333333333333333333333333333333333333333
3itemA     33itemB33itemC33itemD33itemE3
3          33     33     33     33     3
3          33     33     33     33     3
3          33     33     33     33     3
3          33     33     33     33     3
3          33     33     33     33     3
3          33     33     33     33     3
3          33     33     33     33     3
3333333333333333333333333333333333333333
2222222222222222222222222222222223333333
2row 1                           3itemF3
2                                3     3
2                                3     3
2                                3     3
2                                3     3
2                                3     3
2                                3     3
2                                3     3
2222222222222222222222222222222223333333
0                                      0
0                                      0
0                                      0
0                                      0
0000000000000000000000000000000000000000
