3333333333332222333333322223333333332222
3itemA     3    3itemB3    3itemC  3   2
3          3    3     3    3       3   2
3          3    3     3    3       3   2
3          3    3     3    3       3   2
3          3    3     3    3       3   2
3          3    3     3    3       3   2
3          3    3     3    3       3   2
3          3    3     3    3       3   2
3333333333332222333333322223333333332222
3333333333333222233333332222333333322222
3itemD      3    3itemE3    3itemF3    2
3           3    3     3    3     3    2
3           3    3     3    3     3    2
3           3    3     3    3     3    2
3           3    3     3    3     3    2
3           3    3     3    3     3    2
3           3    3     3    3     3    2
3           3    3     3    3     3    2
3333333333333222233333332222333333322222
0                                      0
0                                      0
0                                      0
0                                      0
0                                      0
0                                      0
0                                      0
0                                      0
0                                      0
0000000000000000000000000000000000000000
