00000000000000000000000000000000000000000000000000
0root                                            0
0                                                0
0                                                0
0                                                0
0         111111111111111111111111111111         0
0         1item-1                      1         0
0         1                            1         0
0         1                            1         0
0         1                            1         0
0         1                            1         0
0         1                            1         0
0         1                            1         0
0         1                            1         0
0         111111111111111111111111111111         0
0         111111111111111111111111111111         0
0         1item-2                      1         0
0         1                            1         0
0         1                            1         0
0         1                            1         0
0         1                            1         0
0         1                            1         0
0         1                            1         0
0         1                            1         0
0         1                            1         0
0         1                            1         0
0         1                            1         0
0         1                            1         0
0         1                            1         0
0         1                            1         0
0         1                            1         0
0         1                            1         0
0         1                            1         0
0         1                            1         0
0         111111111111111111111111111111         0
0         111111111111111111111111111111         0
0         1item-3                      1         0
0         1                            1         0
0         1                            1         0
0         1                            1         0
0         1                            1         0
0         1                            1         0
0         1                            1         0
0         1                            1         0
0         1                            1         0
0         1                            1         0
0         1                            1         0
0         1                            1         0
0         1                            1         0
0         1                            1         0
0         1                            1         0
0         1                            1         0
0         1                            1         0
0         1                            1         0
0         1                            1         0
0         1                            1         0
0         1                            1         0
0         1                            1         0
0         1                            1         0
0         1                            1         0
0         1                            1         0
0         1                            1         0
0         1                            1         0
0         1                            1         0
0         1                            1         0
0         1                            1         0
0         1                            1         0
0         1                            1         0
0         1                            1         0
0         1                            1         0
0         1                            1         0
0         1                            1         0
0         1                            1         0
0         1                            1         0
0         1                            1         0
0         1                            1         0
0         1                            1         0
0         1                            1         0
0         1                            1         0
0         1                            1         0
0         1                            1         0
0         1                            1         0
0         1                            1         0
0         1                            1         0
0         1                            1         0
0         1                            1         0
0         1                            1         0
0         1                            1         0
0         1                            1         0
0         1                            1         0
0         1                            1         0
0         1                            1         0
0         1                            1         0
0         1                            1         0
0         111111111111111111111111111111         0
0                                                0
0                                                0
0                                                0
0                                                0
00000000000000000000000000000000000000000000000000
