11111111111111111111111111111111111111111111111111
1item-1                                          1
1                                                1
1                                                1
1                                                1
1                                                1
1                                                1
1                                                1
1                                                1
11111111111111111111111111111111111111111111111111
0                                                0
0                                                0
0                                                0
0                                                0
0                                                0
11111111111111111111111111111111111111111111111111
1item-2                                          1
1                                                1
1                                                1
1                                                1
1                                                1
1                                                1
1                                                1
1                                                1
1                                                1
1                                                1
1                                                1
1                                                1
1                                                1
1                                                1
1                                                1
1                                                1
1                                                1
1                                                1
11111111111111111111111111111111111111111111111111
0                                                0
0                                                0
0                                                0
0                                                0
0                                                0
11111111111111111111111111111111111111111111111111
1item-3                                          1
1                                                1
1                                                1
1                                                1
1                                                1
1                                                1
1                                                1
1                                                1
1                                                1
1                                                1
1                                                1
1                                                1
1                                                1
1                                                1
1                                                1
1                                                1
1                                                1
1                                                1
1                                                1
1                                                1
1                                                1
1                                                1
1                                                1
1                                                1
1                                                1
1                                                1
1                                                1
1                                                1
1                                                1
1                                                1
1                                                1
1                                                1
1                                                1
1                                                1
1                                                1
1                                                1
1                                                1
1                                                1
1                                                1
1                                                1
1                                                1
1                                                1
1                                                1
1                                                1
1                                                1
1                                                1
1                                                1
1                                                1
1                                                1
1                                                1
1                                                1
1                                                1
1                                                1
1                                                1
1                                                1
1                                                1
1                                                1
1                                                1
11111111111111111111111111111111111111111111111111
