..................................................
.item-1                                          .
.                                                .
.                                                .
.                                                .
.                                                .
.                                                .
.                                                .
.                                                .
..................................................
..................................................
.item-2                                          .
.                                                .
. .............................................  .
. .item-2a      ..item-2b      ..item-2c      .  .
. .             ..             ..             .  .
. .             ..             ..             .  .
. .             ..             ..             .  .
. .             ..             ..             .  .
. .             ..             ..             .  .
. .             ..             ..             .  .
. .             ..             ..             .  .
. .............................................  .
.                                                .
.                                                .
.                                                .
.                                                .
.                                                .
.                                                .
..................................................
..................................................
.item-3                                          .
..................................................
.item-3a                                         .
.                                                .
.                                                .
.                                                .
.                                                .
.                                                .
.                                                .
.                                                .
.                                                .
.                                                .
.                                                .
.                                                .
.                                                .
.                                                .
.                                                .
.                                                .
.                                                .
.                                                .
.                                                .
.                                                .
.                                                .
.                                                .
.                                                .
..................................................
.                                                .
.                                                .
.                                                .
..................................................
.item-3b                                         .
.                                                .
.                                                .
.                                                .
.                                                .
.                                                .
.                                                .
.                                                .
.                                                .
.                                                .
.                                                .
.                                                .
.                                                .
.                                                .
.                                                .
.                                                .
.                                                .
.                                                .
.                                                .
.                                                .
.                                                .
.                                                .
.                                                .
..................................................
.                                                .
.                                                .
.                                                .
..................................................
.item-3c                                         .
.                                                .
.                                                .
.                                                .
.                                                .
.                                                .
.                                                .
.                                                .
..................................................
.                                                .
..................................................
