...........................................................................     
.        ..                  ..             ..                            .     
.        ..                  ..             ..                            .     
.        ..                  ..             ..                            .     
.        ..                  ..             ..                            .     
.        ..                  ..             ..                            .     
.        ..                  ..             ..                            .     
.        ..                  ..             ..                            .     
.        ..                  ..             ..                            .     
...............................             ..                            .     
                              .             ..                            .     
                              .             ..                            .     
                              .             ..                            .     
                              .             ..                            .     
                              ................                            .     
                                             .                            .     
                                             ..............................     
................................................................................
.                                                          ..                  .
.                                                          ..                  .
.                                                          ..                  .
.                                                          ..                  .
.                                                          ..                  .
.                                                          ..                  .
.                                                          ..                  .
.                                                          ..                  .
................................................................................
.................................................................               
.             ..                                                .               
.             ..                                                .               
.             ..                                                .               
.             ..                                                .               
.             ..                                                .               
.             ..                                                .               
.             ..                                                .               
.             ..                                                .               
.................................................................               
...............................................................                 
.                   ..                   ..                   .                 
.                   ..                   ..                   .                 
.                   ..                   ..                   .                 
.                   ..                   ..                   .                 
.                   ..                   ..                   .                 
.                   ..                   ..                   .                 
.                   ..                   ..                   .                 
.                   ..                   ..                   .                 
...............................................................                 
                                                                                
                                                                                
                                                                                
