11111111111111111111111111111111111111111111111111
1item-1                                          1
1                                                1
1                                                1
1                                                1
1                                                1
1                                                1
1                                                1
1                                                1
11111111111111111111111111111111111111111111111111
11111111111111111111111111111111111111111111111111
1item-2                                          1
1                                                1
1 2222222222222222222222222222222222222222222222 1
1 2item-2a      22item-2b      22item-2c       2 1
1 2             22             22              2 1
1 2             22             22              2 1
1 2             22             22              2 1
1 2             22             22              2 1
1 2             22             22              2 1
1 2             22             22              2 1
1 2             22             22              2 1
1 2222222222222222222222222222222222222222222222 1
1                                                1
1                                                1
1                                                1
1                                                1
1                                                1
1                                                1
11111111111111111111111111111111111111111111111111
11111111111111111111111111111111111111111111111111
1item-3                                          1
22222222222222222222222222222222222222222222222222
2item-3a                                         2
2                                                2
2                                                2
2                                                2
2                                                2
2                                                2
2                                                2
2                                                2
2                                                2
2                                                2
2                                                2
2                                                2
2                                                2
2                                                2
2                                                2
2                                                2
2                                                2
2                                                2
2                                                2
2                                                2
2                                                2
2                                                2
2                                                2
22222222222222222222222222222222222222222222222222
1                                                1
1                                                1
1                                                1
22222222222222222222222222222222222222222222222222
2item-3b                                         2
2                                                2
2                                                2
2                                                2
2                                                2
2                                                2
2                                                2
2                                                2
2                                                2
2                                                2
2                                                2
2                                                2
2                                                2
2                                                2
2                                                2
2                                                2
2                                                2
2                                                2
2                                                2
2                                                2
2                                                2
2                                                2
2                                                2
22222222222222222222222222222222222222222222222222
1                                                1
1                                                1
1                                                1
22222222222222222222222222222222222222222222222222
2item-3c                                         2
2                                                2
2                                                2
2                                                2
2                                                2
2                                                2
2                                                2
2                                                2
22222222222222222222222222222222222222222222222222
1                                                1
11111111111111111111111111111111111111111111111111
